        
        
        
        
                                              _______                  ________              
                           /### /#######     |       \                |        \             
                           /### /#########   |        \  _          _ |   ___   |            
                           /### /##########  |    |    ||_|        |_||         |            
                           /### /########### |    |    | _   ____   _ |    ____/____   _____ 
                           /### /########### |    |    || | /    \ | ||   |    /    \ |     \
                           /### /##########  |    |    || ||  __  || ||   |   |  --  ||     |
                           /### /#########   |        / | ||      || ||   |   |  ____||  |  |
                           /### /#######/    |_______/  |_| \___  ||_||___|    \____\ |__|__|
                  /####### /### ///////                     /     |                          
                /######### /###                             \____/                           
               /########## /###                                                              
              /########### /###                                                              
              /########### /###      _____ ___   ___ __  _  __ ___ __ __       _     _  _    
              //########## /### ||\||_  | | | | | | |__ | ||__  | |__|  |_||\|| ||  | || _|_|
               //######### /### || |__| | | | |_| | |__ |_||    | |__|__| || ||_||__|_||_| | 
                ///####### /###                                                              
                  ///////  ///       

              ALL CONTENT (C) 2017 DIGIPEN INSITUTTE OF TECHNOLOGY SINGAPORE, ALL RIGHTS RESERVED.
                                      
                                      <============PRESS ENTER KEY============>